1111111111111111111111111
1511110001000100000000001
1041000100010000011100001
1011010111111111000111101
1000010000000001110100101
1111110101010000014100101
1000000101011110011100101
1011110101000010000000101
1001410101111011110110101
1100010100000000000011101
1111110111111111110000101
1400010000000000010101101
1111010111111111010101001
1001010100100001010101101
1001010110101011010100101
1000000000101001010001101
1001111111101000011101001
1000100014101111010101101
1000001000101000000100141
1111111111131111111111111
